w w w w w w w w w w w w w w
w a a a a a a a a a a a a w
w a a a a a a a a a a a a w
w a a a a a a a a a a a a w
w a a a a a i a a f a a a w
w a a a a i a a a f a a a w
w a a a a a a a a a a a a w
w a a a a a a a a a a a a w
w a a a a a a a a a a a a w
w a a a a a a a a a a a a w
w a a f a a p a f i a a a w
w a a a a a a a a a a a a w
w a a a a a a a a a a a a w
w a a a a a a a a a a a a w
w a a a a f a a a a a a a w
w a a a a a i a a i a a a w
w a a a a a a a a a a a a w
w a a a a a a a a a a a a w
w a a a a a a a a a a a a w
w w w w w w w w w w w w w w