w w w w w w w w w w w w w w
w a a a a a a a a a a a w w
w a i a i a p a i a i a w w
w a a a a a a a a a a a w w
w a a * * a a * * a a a w w
w a * * * * a * * * * a w w
w a * * * * a * * * * a w w
w a a * * a a * * a a a w w
w a a a a a a a a a a a w w
w a m m m m m m m m m a w w
w a a a a a a a a a a a w w
w a a y y a a a a y y a w w
w a y y y y a y y y y a w w
w a y y y y a y y y y a w w
w a a y y a a a a y y a w w
w a a a a a a a a a a a w w
w a a a a f f f f a a a w w
w a a a a a a a a a a a w w
w w w w w w w w w w w w w w
w w w w w w w w w w w w w w