w w w w w w w w w w w w w w
w w } a a a a a a a a a + w
w w a w w w w w w w w w a w
w f a p w i a a a a a w a w
w w w a w a i i i a i w a w
w a i a a i a a i a a w a w
w a i a a a i i a i i w a w
w i i i i i i a i a a w a w
w a i a a i a i i i a w a w
w i i i i i i w a a a w a w
w a a a a a i w a i a w a w
w a i i i a i w a i a w a w
w a a i a a a w a i i w a w
w a i a w a a w a i a w a w
w a i a w i i i i i a w a w
w i i i w a a i a a a w a w
w a a a w a a i a i a w a w
w w a w w w w w w w w w a w
w a a g a a a a a a a a { w
w w w w w w w w w w w w w w