w w w w w w w w w w w w w w
w w w w w w w w w w w w w w
w w w w w w w w w w w w w w
w w w w w w w w w w w w w w
w a a a a a a a a a a a a w
w a i a a i i a f a a f a w
w a i a i a i f a a a f a w
w a i a i p i f f f f f a w
w a i a i a i a a a a f a w
w a a i a a i a a a a f a w
w a a f f f a a i a a i a w
w a f a a a f i a a a i a w
w a f a a a f i i i i i a w
w a f a a a f a a a a i a w
w a a f f f a a a a a i a w
w a a a a a a a a a a a a w
w w w w w w w w w w w w w w
w w w w w w w w w w w w w w
w w w w w w w w w w w w w w
w w w w w w w w w w w w w w