w w w w w w w w w w w w w w
w a a a w a a a a a w a a w
w a a a w a a a a a w g a w
w a a f w a a a a a w a a w
w a a f w a f w a a w i a w
w a a f w a f w a f w a a w
w a a f w a f w a f w i a w
w a a f w a f w a f w a a w
w a a f w a f w a f w i a w
w a a f w a f w a f w a a w
w a a f w a f w a f w i a w
w a a f w a f w a f w a a w
w a a f w a f w a f w i a w
w a a f w a f w a f w a a w
w a a f w a f w a f w i a w
w a a f w a f w a f w p a w
w a a f w a a w a f w i a w
w a a a a a a w a a a a a w
w a a a a a a w a a a a a w
w w w w w w w w w w w w w w