w w w w w w w w w w w w w w
w w w w w a a a w w w w w w
w w w w w p a a w w w w w w
w w w w w a m a w w w w w w
w w w w w a a a w w w w w w
w w w w w a a a w w w w w w
w w w w w w y w w w w w w w
w w w w w a a a w w w w w w
w w w w w a i a w w w w w w
w w w w w a a a w w w w w w
w w w w w a a a w w w w w w
w w w w w a i a w w w w w w
w w w w w a a a w w w w w w
w w w w w w * w w w w w w w
w w w w w a a a w w w w w w
w w w w w a a a w w w w w w
w w w w w a f a w w w w w w
w w w w w a a a w w w w w w
w w w w w a a a w w w w w w
w w w w w w w w w w w w w w