w w w w w w w w w w w w w w
w w w w w w w w w w w w w w
w w w w w w w w w w w w w w
w w w w w w w w w w w w w w
w w w w w w w w w w w w w w
w w f i w i w i w i f w w w
w w f i a i a i a i f w w w
w w f i a i a i a i f w w w
w w f i a i a i a i f w w w
w w f i a i p i a i f w w w
w w f i a i a i a i f w w w
w w f i a i a i a i f w w w
w w f i a i a i a i f w w w
w w f i w i w i w i f w w w
w w w w w w w w w w w w w w
w w w w w w w w w w w w w w
w w w w w w w w w w w w w w
w w w w w w w w w w w w w w
w w w w w w w w w w w w w w
w w w w w w w w w w w w w w