w w w w w w w w w w w w w w
w w w w w w w w w w w w w w
w w w w w w w w w w w w w w
w w w w w w w w w w w w w w
w w w w w w w w w w w w w w
w w p a a a a a a a a w w w
w w a g f f f f f g a w w w
w w a f w w w w w f a w w w
w w a f f f f f f f a w w w
w w a g f f f f f g a w w w
w w a f f f f f f f a w w w
w w a f w w w w w f a w w w
w w a g f f f f f g a w w w
w w a a a a a a a a a w w w
w w w w w w w w w w w w w w
w w w w w w w w w w w w w w
w w w w w w w w w w w w w w
w w w w w w w w w w w w w w
w w w w w w w w w w w w w w
w w w w w w w w w w w w w w