w w w w w w w w w w w w w w
w w w w w w w w w w w w w w
w w w w w w w w w w w w w w
w w w w w w w w w w w w w w
w w w w w w w w w w w w w w
w w a a a a a a a a a a w w
w w a g a a a a a a i a w w
w w a a i a a a a i a a w w
w w a a a f f f f a a a w w
w w a p a f a a f a a a w w
w w a a a f a a f a a a w w
w w a a a f f f f a a a w w
w w a a i a a a a i a a w w
w w a i a a a a a a i a w w
w w a a a a a a a a a a w w
w w w w w w w w w w w w w w
w w w w w w w w w w w w w w
w w w w w w w w w w w w w w
w w w w w w w w w w w w w w
w w w w w w w w w w w w w w