w w w w w w w w w w w w w w
w a a a a a a a a a a a a w
w a a a a a a a i a a a a w
w a a a a a i i a a a a a w
w a a a a i a i i a i a a w
w a a a i a i i a a a i a w
w a a i i i p i i i i i a w
w a a a i a i i a a a a a w
w a a a a i a i i a a a a w
w a a a a a i i a a a a a w
w a a a a a a a i a a a a w
w a a a a f a a a a a a a w
w a a f a a a f a a a a a w
w a a a f f f a a a a a a w
w a f a f g f a f a a a a w
w a a a f f f a a a a a a w
w a a f a a a f a a a a a w
w a a a a f a a a a a a a w
w a a a a a a a a a a a a w
w w w w w w w w w w w w w w