w w w w w w w w w w w w w w
w a a a a a a a a a a a a w
w a a a i a a a f a i a a w
w a i a i a a f a a a a a w
w a a a a a a a a f a a a w
w a a a a a a a a i a f a w
w a a a a a f i p a a a a w
w a a a a a a a a a f a a w
w a a a a a a a a a a a a w
w a a a a a a a i a i a a w
w a a i a a a a f a a f a w
w a a a a a a i a a a a a w
w a a a a a a a a a a a a w
w a a a a a a a a a i a a w
w a a a f a a a a a a a a w
w a a i a a a a a f a a a w
w a a a f a a a a a a f a w
w a a a a a a a a i f a a w
w a a a a a a a a a a a a w
w w w w w w w w w w w w w w