w w w w w w w w w w w w w w
w a a a a a a a a a a a a w
w a a a a i a a a a f a a w
w a a a a a a a a a f a a w
w a a a a i a a a a f a a w
w a a a a a a a a a f a a w
w a a a a i a a a a f a a w
w a a a a a a a a a f a a w
w a a a a i a a a a f a a w
w a a a a a a a a a f a a w
w a a a a g a a a a f a a w
w a a a a a a a a a f a a w
w a a a a a a a a a f a a w
w a a a a a a a a a f a a w
w a a a a p a a a a f a a w
w a a a a a a a a a f a a w
w a a a a a a a a a f a a w
w a a a a a a a a a f a a w
w a a f f f f f f f f a a w
w w w w w w w w w w w w w w