w w w w w w w w w w w w w w
w a a a a a a a a a a a w w
w a a a a a m a a p a a w w
w a a a * a a a a a a a w w
w a a a a a a a y i a a w w
w a a a a a a a a a a a w w
w a a a a a a a a * a a w w 
w a a y a a a a a a a a w w
w a a a a a a a a a a a w w
w a m a a a f a a a m a w w
w a a a a a a * a a a a w w
w a a a a a a a a a a a w w
w a a a a a a a y a a a w w
w a a a * a a a a a a a w w
w a a a a a a a a y a a w w
w a a a a a a a a a a a w w
w a a a a a m a a a a a w w
w a a a a a a a a a a a w w
w w w w w w w w w w w w w w
w w w w w w w w w w w w w w