w w w w w w w w w w w w w w
w a a a a a a a a a a a a w
w a a a a a a a a a a a a w
w a a a a a a a a a a a a w
w a a a a i a a a a a a a w
w a a a a a a a a f a a a w
w a a a a a a a a a a a a w
w a a a a a a a a a a a a w
w a a a a a a a a a a a a w
w a a a a a a a a a a a a w
w a a a a a a a a a a a a w
w a a a a a a a a a a a a w
w a a a i a p i a a f a a w
w a a a a a a a a a a a a w
w a a a a a a a a a a a a w
w a a a a f a a a a a a a w
w a a a a a a a a a a a a w
w a a a a a a a a a a a a w
w a a a a a a a a a a a a w
w w w w w w w w w w w w w w
