w w w w w w w w w w w w w w
w a a a a a a a a a a a a w
w a a a a i i i i a a a a w
w a a a a a a a a a a a a w
w a a a a i a a i a a a a w
w a a a a a i i a a a a a w
w a a a a a a a a a a a a w
w a a a a i a a i a a a a w
w a a a a w w w w a a a a w
w a a a w w p a w w a a a w
w a a a w a a a a w a a a w
w a a a a a w w a a a a a w
w a a a a a a a a a a a a w
w a a w f w a a w f w a a w
w a a w a w a a w a w a a w
w a a a a f a a f a a a a w
w a a w w w w w w w w a a w
w a a a a a a a a a a a a w
w a a a a a a a a a a a a w
w w w w w w w w w w w w w w