w w w w w w w w w w w w w w
w a a a a a a a a a a a a w
w a a a a a a a a a a a a w
w a a a a a a a a a a a a w
w f a a a a i a a a a a a w
w f a a a a a a a a a a a w
w f a a a i a i a a a a a w
w f a a a a a a a a a a a w
w f a a a a i a i a a a a w
w f a a a a a a a a a a a w
w f a a a i a i a i a a p w
w f a a a a a a a a a a a w
w f a a a a i a i a a a a w
w f a a a a a a a a a a a w
w f a a a i a i a a a a a w
w f a a a a a a a a a a a w
w f a a a a i a a a a a a w
w a a a a a a a a a a a a w
w a a a a a a a a a a a a w
w w w w w w w w w w w w w w