w w w w w w w w w w w w w w
w w w w w a a a a w w w w w
w w w w w a w w a w w w w w
w a a a a m a a i w w w w w
w a w w w a w w a w a a w w
w a w w a a a a a a a a w w
w a w w a a a w * w a a w w
w a a a y a a a a a a a w w
w w a w a w a w a w w a w w
w w a w a w i w a w w a w w
w w a a a a a w y w w a w w
w w * a a a a a a a a a w w
w w a a a w a w a w w a w w
w w a a a w a w a a w a w w
w w w a a a a y a a w a w w
w w w w a w w p a a w a a w
w w w w f w f a i a f a a w
w w w w w w w a a w w w w w
w w w w w w w w w w w w w w
w w w w w w w w w w w w w w