w w w w w w w w w w w w w w
w w a a a a a a a a a a w w
w a a a a a a a a a a a a w
w a a a a a a a a a a a a w
w a a i a a a i a a a a a w
w a a a a a a w a a a i a w
w a a a a a a a a a a a a w
w a a a a a w a w a a a a w
w a a a a a a a a a a a a w
w a a a a w a f p w a a a w
w a a a a a a a a a a a a w
w a a a a a w a w a a a a w
w a i a a a a a a a a a a w
w a a a a a a w a a a a a w
w a a a a a a i a a a a a w
w a a a a a a a a a a a a w
w a a i a a a a i a a a a w
w w a a a a a a a a a a w w
w w w w w w w w w w w w w w
w w w w w w w w w w w w w w