w w w w w w w w w w w w w w
w w w w w w w w w w w w w w
w w w w w w w w w w w w w w
w a a a a a a a a a a a w w
w a a a a a a a a a a a w w
w a i a w w w a a a i a w w
w a a a a a a a a a a a w w
w a a a a a a a a a a a w w
w a a w a a w w w w a a w w
w a a w a a i p f w a a w w
w a a w a a i a f w a a w w
w a a w a a w w w w a a w w
w a a a a a a a a a a a w w
w a a a a a a a a a a a w w
w a i a w w w a a a i a w w
w a a a a a a a a a a a w w
w a a a a a a a a a a a w w
w w w w w w w w w w w w w w
w w w w w w w w w w w w w w
w w w w w w w w w w w w w w