w w w w w w w w w w w w w w
w a y a a a a a a a * a w w
w a y a a a a a m a * a w w
w a y a f f f f f a * a w w
w a y a a a a a a a * a w w
w a y a a a i a a a * a w w
w a y a g f a f f a * a w w 
w a y a f a a a f a * a w w
w a y a f a a a f a * a w w
w a y a a a p a a a * a w w
w a y a f a a a f a * a w w
w a y a f a a a f a * a w w
w a y a f f a f f a * a w w
w a y a a i a i a a * a w w
w a y a a a a a a a * a w w
w a y a f f f f f a * a w w
w a y a m a a a a a * a w w
w a y a a a a a a a * a w w
w w w w w w w w w w w w w w
w w w w w w w w w w w w w w