w w w w w w w w w w w w w w
w a a a a a a f a a a a a w
w a a a a a a f a a a a a w
w a a a a a a f a a a a a w
w a a a a a a f a a a a a w
w a a a a a a i a w a a a w
w a a a a a w i a a a a a w
w a a a a a a i a a w a a w
w a w a a a a i a a a a a w
w a a a a a a i a a a w a w
w a a a a a a i a a a a a w
w w a a a a a i a a a a a w
w a a a a a a i w a a a a w
w a a w a a a i p a a a a w
w a a a a a a f a a a a a w
w a a a a a a f a a a a a w
w a a a a a a f a a a a a w
w a a a a a a f a a a a a w
w a a a a a a f a a a a a w
w w w w w w w w w w w w w w