w w w w w w w w w w w w w w
w w w w w w w w w w w w w w
w w w w w w w w w w w w w w
w w w w w w w w w w w w w w
w w a a a a a a a a a a w w
w a a a a a a a a a a a a w
w a i a w w w w a a a a a w
w a a a w f f w a a a a a w
w a i a w p a w a a a a a w
w a a a w i i w a a a i a w
w a i a a a a a a a a a a w
w a a a a a a a a a a a a w
w a a a a a a a a a w a a w
w a a a a w w a a a w a a w
w a a a a a a a a a a a w w
w w a a a a a a a a a a w w
w w w w w w w w w w w w w w
w w w w w w w w w w w w w w
w w w w w w w w w w w w w w
w w w w w w w w w w w w w w