w w w w w w w w w w w w w w
w w w w w w w w w w w w w w
w w w w w w w w w w w w w w
w w w w w w w w w w w w w w
w a a a a a a a a a a a w w
w a i a i a a a i a i a w w
w a a a a a a a a a a a w w
w a i a w a a a w a i a w w
w a a a a f a f a a a a w w
w a a p a a f a a a a a w w
w a a a a f a f a a a a w w
w a i a w a a a w a i a w w
w a a a a a a a a a a a w w
w a i a i a a a i a i a w w
w a a a a a a a a a a a w w
w w w w w w w w w w w w w w
w w w w w w w w w w w w w w
w w w w w w w w w w w w w w
w w w w w w w w w w w w w w
w w w w w w w w w w w w w w