w w w w w w w w w w w w w w
w w w w w w w w w w w w w w
w w w w w w w w w w w w w w
w w w w w w w w w w w w w w
w a a a a a a a a a a w w w
w a p a a i a a i a a w w w
w a a a a a a a a a a w w w
w w w w w w w w w a a a w w
w a a a a a a a a a a a w w
w a a a a a a a a a a a w w
w a a a a a a a a a a a w w
w a a a w w w w w w w w w w
w a a a a a a a a a a a w w
w a a a a a a a a a f a w w
w w w w a a a a a a a a w w
w w w w w w w w w w w w w w
w w w w w w w w w w w w w w
w w w w w w w w w w w w w w
w w w w w w w w w w w w w w
w w w w w w w w w w w w w w