w w w w w w w w w w w w w w
w a a a a a a f a a a a a w
w a a a f a a a a f a a a w
w a f a a a a a a a a a a w
w a a a i a a a a i a a a w
w a a i i a a a a i i a a w
w a a a a i a a i a a a a w
w a a a a i a i i a a a a w
w i a a a a i i a a a a i w
w a i i i i p i i i i i a w
w i a a a a i i a a a a i w
w a a a a i a i i a a a a w
w a a a a i a a i a a a a w
w a a i i a a a a i i a a w
w a a a i a a a a i a a a w
w a a a a a a a a a a a a w
w a a f a a a a a a f a a w
w a a a a f a a f a a a a w
w a a a a a a a a a a a a w
w w w w w w w w w w w w w w