w w w w w w w w w w w w w w
w w w w w w w w w w w w w w
w w w w w w w w w w w w w w
w w w w w w w w w w w w w w
w w w w w w w w w w w w w w
w w a a a a a a a a a a w w
w w a p i a a a i a a a w w
w w a i g f f f f i a a w w
w w a a f a a a f a a a w w
w w a a f a a a f a a a w w
w w a a f a a a f a a a w w
w w a i f f f f f i a a w w
w w a a i a a a i a a a w w
w w a a a a a a a a a a w w
w w w w w w w w w w w w w w
w w w w w w w w w w w w w w
w w w w w w w w w w w w w w
w w w w w w w w w w w w w w
w w w w w w w w w w w w w w
w w w w w w w w w w w w w w