w w w w w w w w w w w w w w
w w w w w w w w w w w w w w
w w w w w w w w w w w w w w
w w w w w w w w w w w w w w
w w w w w w w w w w w w w w
w w w w w w a a a a a a w w
w w w a p i a a a a } a w w
w w w a a w a a a a a a w w
w w w i w w a a a a a a w w
w w } a a a a + a a a a w w
w w a a a a a a f a a a w w
w w a a a a a a a a a a w w
w w a - a a a { a a a a w w
w w a a a a a a a a a a w w
w w - a { a a a a a + a w w
w w a a a a a a a a a a w w
w w w w w w w w w w w w w w
w w w w w w w w w w w w w w
w w w w w w w w w w w w w w
w w w w w w w w w w w w w w