w w w w w w w w w w w w w w
w a a a a a a a a a a a a w
w a i a a i a a i a a i a w
w a a a a a a a a a a a a w
w a a a p a w w a a a a a w
w a a a a a w w a a w w a w
w a a a a a a a a a w w a w
w a w w a a a a a a a a a w
w a w w a a f f a a a a a w
w a a a a a f f w w a a w w
w w w a a a f f w w a a w w
w w w a w w f f a a a a a w
w a a a w w a w w a a a a w
w a a a a a a w w a a w w w
w a a a a a a a a a a w w w
w a a a a a a a a a a a a w
w a i a a i a a i a a i a w
w a a a a a a a a a a a a w
w a a a a a a a a a a a a w
w w w w w w w w w w w w w w