w w w w w w w w w w w w w w
w a a a a a a a a a a a a w
w a a a a a a a a a a a a w
w a a a a a a a a a a a a w
w a a a a a w a a a a a a w
w a a a a w a w a a a a a w
w a a a w a a a w a a a a w
w a a w a a a a a w a a a w
w a w a a a i a a a w a a w
w w a a p a i f f a a w a w
w a w a a a i f f a w w w w
w a a w a a i a a w w w a w
w a a a w a a a w w w a a w
w a a a a w a w w w a a a w
w a a a a a w w w a a a a w
w a a a a a a w a a a a a w
w a a a a a a a a a a a a w
w a a a a a a a a a a a a w
w a a a a a a a a a a a a w
w w w w w w w w w w w w w w